+---+---+---+---+---+---+---+---+---+---+---+---+---+---+---+---+
|   |       |                                                   |
+   +   +   +---+   +   +   +   +   +   +   +   +   +   +   +   +
|   |                                                           |
+   +   +   +   +   +   +   +   +   +   +   +   +   +   +   +   +
|                                                               |
+   +   +   +   +   +   +   +   +   +   +   +   +   +   +   +   +
|                                                               |
+   +   +   +   +   +   +   +   +   +   +   +   +   +   +   +   +
|                                                               |
+---+---+---+---+---+---+---+   +   +   +   +   +   +   +   +   +
|                           |                                   |
+   +   +   +   +   +   +   +   +   +   +   +   +   +   +   +   +
|                                                               |
+   +   +   +   +   +   +   +   +   +   +   +   +   +   +   +   +
|                                                               |
+   +   +   +   +   +   +   +---+---+   +   +   +   +   +   +   +
|                           |       |                           |
+   +   +   +   +   +   +   +---+   +   +   +   +   +   +   +   +
|                               |   |                           |
+---+   +---+---+---+---+---+---+---+   +   +   +   +   +   +   +
|   |   |                           |                           |
+   +   +   +---+---+---+---+---+   +   +   +   +   +   +   +   +
|   |   |   |                   |   |                           |
+   +---+   +   +   +   +   +   +   +   +   +   +   +   +   +   +
|           |                   |   |                           |
+   +---+---+   +   +   +   +   +   +   +   +   +   +   +   +   +
|   |                           |   |                           |
+   +   +   +   +   +   +   +   +   +   +   +   +   +   +   +   +
|   |                           |   |                           |
+   +   +   +   +   +   +   +   +   +   +   +   +   +   +   +   +
|   |                           |   |                           |
+---+---+---+---+---+---+---+---+---+---+---+---+---+---+---+---+
